1111111
1P00C01
10000E11
1111111