1111111
1P00C01
10P00E1
1111111