111111
10P101
100011
10C011
1001E1
111111