11111M1
1P00C01
10000E1
1111111