1111111111111111111111111111111
1P000C000011111000C000000C00001
1110111000100011110001111100001
1000100010101000000001000010111
1011100000101101111001111000001
100000C010000000000000000011111
100000011111100100010000C000001
1000001000000010000111100000001
1011111011111011111000000000001
100000000C000C000C0000000000001
10000000000000000000000E0000001
1111111111111111111111111111111