1111111111111111111111
10P0000000111110000001
1000000C00001001110001
1000001110100000010001
1000000C00100000000001
1001100000000C00001001
10000C0011000000000001
1110000000000C00001001
101000C00010000000C001
1000C0000111000C000001
1000000C0000001000E001
1111111111111111111111