1111111
1P00C01
1000E01
1111111